NO ./walls/end.xpm
SO ./walls/nether.xpm
WE ./walls/dirt.xpm
EA ./walls/stone.xpm
DO ./walls/door.xpm

F 124,252,0
C 135,206,235

            11111111111111111111111111111111111111
            10000001000001011100001011000000100001
            10010110010100100010010100110100100111
            11001010100101011001010100101001000011
            10000001010111010000000100101010000001
            10000000011110010010101001001000011111
            10000000000111010010100100101010100011
            10001010100101001010100010010101001001
1111111111111111111111111111111111111100S000000001
10000000000000000000000000000000000000D11111111111
10000000000000000000000000000000000000001111111111
1D1111111111111111111D1111111111111D11111
101                 100001        101
101                 100001        101
101                 100001        101
101                 100001        101
101                 100001        101
101                 100001        101
101                 100001        101
101                 100001        101
101                 100001        101
101                 100001        101
101                 100001        101
101                 100001        101
101                 100001        101
101111111111111111111111011111111110111111111
1000000000000000000000000000000000000000001
11111111111111111111111111111111111111111111
